x                    2  x
x xxxxx xxx   xxx xxxxx x
x x   x xx   x xx x   x x
x x   x x       x x   x x
x x   x x       x x   x x
x           x           x
x                       x
x                       x
x  1       x            x
x                       x
x                       x
x         x             x
x                       x
x                       x
x        x              x
x           x           x
x      xxxx             x
x     x   x             x
xxxxxxxxxxxxxxxxxxxxxxxxx
end