x xxxxx xxxx xxxx xxxxx x
x xxxxx xxx   xxx xxxxx x
x xxxxx xx     xx xxxxx x
x xxxxx x       x xxxxx x
x xxxxx x       x xxxxx x
x                       x
x                       x
x                       x
x                       x
x                       x
x                       x
x                       x
x                       x
x                       x
x      x x              x
x 1                     x
x     xxxxx             x
x                       x
xxxxxxxxxxxxxxxxxxxxxxxxx
end