x                       x
x xxxxx xxx   xxx xxxxx x
x       xx   x xx x   x x
x       x       x x   x x
x       x       x x   x x
x           x           x
x                       x
x                       x
x          x            x
x                       x
x                       x
x         x             x
x                       x
x                       x
x      x x              x
x                       x
x 1   xxxxx             x
x                       x
xxxxxxxxxxxxxxxxxxxxxxxxx
end